[
----------------------------------|
-                                -|
-                                -|
----*                    --     --|
-            --                  -|
-                                -|
-                         *      -|
-                                -|
--      ----*------------        -|
-                                -|
--                               -|
-                                -|
-                           *--- -|
-                                -|
-                                -|
-     *---                       -|
-                                -|
-   --------       *----         -|
-                                -|
-                         -      -|
-                            --  -|
-                                -|
-                                -|
----------*----              --  -|
-                             *  -|
-                                -|
----------------------------------|
]