[
----------------------------------|
-                                -|
-                                -|
----                     --     --|
-            --                  -|
-                        *       -|
-                                -|
-                                -|
--      *            ----        -|
-                                -|
--                               -|
-                                -|
-                            --- -|
-                *               -|
-                                -|
-      ---                       -|
-                                -|
-   --------        ----         -|
-                                -|
-                         -      -|
-                            --  -|
-       *                        -|
-           P                    -|
---------------              --  -|
-                                -|
-                     *          -|
----------------------------------|
]